720
 _________
| | |___  |
| |___    |
|  _  | |_|
| | | |   |
|S|_____|_|
